................
..wswswswsws....
..wn__we__wn....
..ws__ww__ws....
..wn__we__wn....
..wswswswsws....
................
